2
Alvares Communolimbus
18 22
5 5
###########$$$$$$$####
#                $%%%#
#                $%%%#
#   ######$$$$$  $   #
#   #            $$  #
#   #@           $$  #
#   #####$$$$$$$$$$  #
#        $       $$$ #
#        $        $$ #
$$$$$    $  ####  $$ #
$    $   $    #   $$ #
$     $  $    #  $$$ #
$  $     $$$  # $$$$ #
$   $    $    # $$$$ #
$    $$$$$    #  $$  #
$             #      #
$             #      #
$$$$$$$$##############