1
Palmilha pontente
10 15
2 2
############$$$
#   $#$%%    $$
# @ $#$%%    $$
#   $#$$$$$   $
#   $#####$   $
#   $$$$$$$   $
#            $$
#            $$
#    $$$    $$$
##$$$$$$$$$$$$$