4
Semente de ab0bora
18 22
3 8
##$$$$$$$$$$$$$$$$$$##
#$$                $$#
$$  $##########$ $  $$
$  $$   @        $$  $
$ $$##############$$ $
$ # $ $$   $       # $
$ # $    $  $$$ $  # #
$ #$    $   $    $ ###
$ #   $ $  $    $  ###
$ #  $  $ $   $$   ###
$ #  $$ $ $  $   $$#%#
$ $ $  $  $ $   $  # #
$      $    $  $ $ # $
$ $$ $$ $$   $    $$ $
$  $$ $   $  $   $$  $
$$  $##########$ $  $$
#$$     #####      $$#
##$$$$$$#####$$$$$$$##