3
Quando nasce o sol encaracolado
10 15
5 5
$$$$$$$$$$$$$$$
$             $
$ $$$$$$$$$$$ $
$ $         $ $
$ $ $$$$$$$ $ $
$ $ $@      $ $
$ $ $$$$$$$$$ $
$%$           $
$$$$$$$$$$$$$$$
$%###%$$$%###%$